cal  = календарь
passwd = изменение своего пароля
df = свободное место на дисках
free = свободное место в оперативной памяти
pwd = выводит название текущего рабочего каталога.
file = определяет тип файла.
less = выводит содержимое файла
file = показать тип файла
rm = удалить файл
rm -r = удалить рекурсивно, и каталог
ln = создать жесткую ссылку
ln -s = содать символическую ссылку
type = получение типа команды
which = определение местоположения выполняемого файла
help = получение справки для встроенных команд
man = вывод страниц справочного руководства
apropos = вывод списка подходящих команд
alias = создание собственных команд
type = инфо
cat = объединение файлов
uniq = поиск или удаление повторяющихся строк
wc = вывод числа строк, слов и байтов
grep = поиск строк, соответствующих шаблону
head/tail = вывод первых/последних строк из файлов
CTRL+R = поступательный поиск
!55 = подстановка записи из истории команд
chmod = изменение режима доступа к файлу
su = войти в консоль под рутом
chown = изменение владельца и группы файла
passwd = изменение своего пароля
ps =  просмотр списка процессов
ps x = вывести все процессы
ps aux = более подробно
top = состояние процессов в динамике
command_name & = запустить команду в фоновом режиме
jobs = список заданий, запущенных в терминале
fg %1 = переместить задачу на передний план
bg %1 = переместить задачу в фон
kill [PID] = завершить процесс
killall = остановка нескольких процессов
nano = консольный графический редактор
mount = команда для монтирования файловых систем
fdisk = программа для нискоуровневой работы с дисками
mkfs = создание новой файловой системы на носителе
fsck = проверка файловой системы
dd = создание копии низкоуровневым способом
md5sum = проверить контрольную сумму
netstat = вывод параметров настройки сети и статистик
netstat -ie = сетевые интерфейсы в системе
netstat -r = получить таблицу маршрутизации ядра
wget = загрузчик файлов
locate = простой способ поиска файлов
find = сложный способ поиска файлов
gzip = сжатие и распаковывание файлов
gunzip = распаковать
bzip2 = более высокая степень сжатия
tar = архивирование
zip = упаковывание и сжатие файлов
rsync = синхронизация файлов и каталогов с удаленной системой
paste = слияние строк из файлов
join = объединение строк из двух файлов по общему полю
comm = построчное сравнение двух сортированных файлов
diff = постраничное сравнение файлов
patch = применение diff-файла к оригиналу
tr = перекодирование или удаление символов
sed = потоковый редактор для фильтрации и преобразования текста
aspell = интерактивная проверка орфографии
nl = нумерация строк
fold = перенос строк после указанной длины
fmt = простое форматирование текста
pr = форматирование текста для печати
printf = форматирование и вывод данных
lpstat -a = получить список принтеров
lpr, lp = печать файлов
lpq = вывод информации о состоянии очереди печати
lprm и cancel = отмена заданий печати
-------------------------------------------------------------------------------
Сетевые

nmcli device список сетевых интерфейсов
nmcli connection подключение устройства к сети
nmcli connection down <interface> отключить данный интерфейс
nmcli connection up <interface> включить
















